XXXXXXXXXXXX
X---------EX
XXX--------X
X----------X
X---S------X
XXXXXXXXXXXX
