-XXXX-------
----------E-
-------X--X-
---XXX-X--X-
-X--------X-
-X----XX--X-
-X---S------
---------X--
---XX----X--
------X-----
-X----------
-X--XX--XXXX
-X----------
